#                  #
#                  #
#                  #
#                  #
#                  #
#                  #
#                  #
#          s       #
#                 ##
#       ############
#      #############
#      #############
#           #  #####
#                  #
####################